000000000000000000000000000000000000000000000000000000000000000000000000000000000000000000000000000000000000000001000
000000000000000000000000000000000000000000000000000000000000000000000000000000000000000000000000000000000000000011100
000000000000000000000000000000000000001100001100000000000000000000000000000000000000000000000000000000000000000111100
000000000000000000000000000000000000010010010010000000000000000000000000000000000000000000000000000000000000000111110
000000000000000000000000000000000000000000000000000000000000000000000000000000000000000000000000000000011100001111110
0000000000000000000000000000000000000000000000000000000000000000000000000000000000000000000000000E0011111000011111110
000000000000000000000000000000000000000000000000000000000000000000000000000000000000000000000000011111100000011111111
000000000000000000000000000000000000001100001100000000000000000000000000000000000000000000000001111111100000011111111
000000000000000000000000000000000000000111111000000000000000000000000000000000000000000000000011111111100000111111111
000000000000000000000000000000000000000000000000000000000002222200000000000000000000000000000111111111100000111111111
000000000000000000000000000000000000000000000000000000000000000000000000000000000000000000000111111111111000001111111
00000000000000000000000000000000000000000000000200E000200000000000000000000000000000000000000111111111100000001111111
000000000000000000000000000000000000000000000002222222200000000000002222000000000000000000000111111000000000000111111
000000000000000000000000000000000000000000000000000000000000000000000000000000000000000000000110000000000001000111111
000000000000000000000000000000000000000000000000000000000000000000000000000000000000000000000000000000000011000111111
000000000000000000000000000000000000000000000000000000000000222222000000000000000000000000000000000000000011100111111
000000000000000000000000000000000000000000000000000000000000000000000000000000000000000000000000001111111111100111111
000000000000000000000000000000000000000000000000000000000000000000000000000000000000000000000110001111111111100111111
000000000000000000000022220000000000000000000000022222222200000000000000000000000000000000000111111111111111100111111
000000000000000000000000000000000000000000110000000000000000000000000000000000000000000000000111111111111110000111111
00000000011110000000000000000000000000000111000000000000000000000000000000000000000000000E001111111111111110000111111
00000000011110000000000000020000E000011111110000E000000000000E0000000000000000000000011111111111111111110000000111111
111111111111111111111000001111111111111111111111111111111111111110000000000000001111111111111111111111000000000111111
111111111111111111111100001111111111111111111111111111111111111110000000000000011111111111111111111100000000001111111
111111111111111111111110000111111111111111111111111111111111111110000000000000011111111111111111111000000000011111111
111111111111111111111110000111111111111111111111111111111111111110000000000000011111111111111111110000000000111111110
111111111111111111111100000011111111111111111111111111111111111110000000000000011111111111111111100000000000111111100
